30 17
64 640
7 7 7 7 7 7 7 7 7 9 0 0 9 0 0 0 0 0 0 0 0 0 0 0 0 0 8 7 7 7
7 7 7 7 7 7 7 7 7 9 0 0 9 0 0 0 0 0 0 0 0 0 0 0 0 0 11 10 10 16
7 7 7 7 7 7 15 10 10 12 0 0 13 1 2 3 4 1 0 0 0 0 0 0 0 0 0 0 0 8
7 7 7 7 7 7 9 0 0 0 0 0 0 0 0 0 0 0 0 17 17 0 0 0 0 0 0 0 0 8
7 7 7 7 7 7 9 0 0 0 0 0 0 0 0 0 0 0 0 0 0 0 0 0 5 1 0 0 0 8
10 10 10 10 16 7 9 0 0 0 0 0 0 0 0 0 0 0 0 0 0 0 0 0 8 0 0 0 0 8
0 0 0 0 8 7 9 0 0 0 0 0 0 0 0 0 0 5 2 3 4 1 2 3 14 0 0 0 5 14
0 0 0 0 8 7 13 1 6 0 0 0 0 0 0 0 1 14 0 0 0 0 0 0 0 0 0 0 8 7
0 0 0 0 8 7 7 7 13 1 6 0 0 0 0 0 0 0 0 0 0 0 0 0 0 0 0 0 8 7
0 0 0 0 8 7 7 7 7 7 9 0 0 17 17 17 0 0 0 0 0 0 0 0 0 0 0 0 8 7
0 0 0 0 8 15 10 10 10 10 12 0 0 0 0 0 0 0 0 0 0 0 0 0 0 0 0 0 8 7
1 6 0 0 11 12 0 0 0 0 0 0 0 0 0 0 0 0 17 17 0 0 0 0 0 0 0 0 8 7
7 9 0 0 0 0 0 0 0 0 0 0 0 0 0 0 0 0 0 0 0 0 0 0 0 0 0 0 8 7
7 9 0 0 0 0 0 0 0 0 0 0 0 0 0 17 17 0 0 0 0 0 0 0 0 0 0 0 8 7
7 9 0 0 0 0 0 0 0 0 0 0 0 0 0 0 0 0 0 0 0 0 0 0 5 1 2 3 14 7
7 13 2 3 4 1 0 0 0 0 1 2 3 4 0 0 0 0 0 0 0 0 0 0 8 7 7 7 7 7
7 7 7 7 7 7 0 0 0 0 7 7 7 7 0 0 0 0 0 0 0 0 0 0 8 7 7 7 7 7


